00000000000000000000000000000000000000000000000000000000000000000000000000000000000000000000000000001111
00000000000000000000000000000000000000000000000000000000000000000000000000000000000000000000000000001111
00000000000000000000000000000000000000000000000000000000000000000000000000000000000000000000000000001111
11110000000000000000000000000000000000000000000000000000000000000000000000000000000000000000000000001111
11110000000000000000000000000000000000000000000000000000000000000000000000000000000000000000000000001111
11110000000000000000000000000222442222220000000000000000000000000000000000000000000000000000000000001111
11110000000000000000000000000000000000000000000000000000000000000000000000000000000000000000000000001111
11110000000000030000000000000000000000000000000000000000000000000000000000000000000000000000000000001111
22222222222222222222442222222222222222222222222222222222222222222222222222222222222222222222222222222222
22222222222222222222222222222222222222222222222222222222222222222222222222222222222222222222222222222222
22222222222222222222222222222222222222222222222222222222222222222222222222222222222222222222222222222222