11110000000000000000000000000000000000000000000000000000000000000000000000000000000000000000000000001111
11110000000000000000000000000000000000000000000000000000000000000000000000000000000000000000000000001111
11110000000000000000000000000000000000000000000000000000000000000000000000000000000000000000000000001111
11110000000000000000000000000000000000000000000000000000000000000000000000000000000000000000000000001111
11110000000000000000000000000000000000000000000000000000000000000000000000000000000000000000000000001111
11110000000000000000000000000000000000000022222200000000000000000000000000000000000000000000000000001111
11110000000000000000000000000000000000000000000000000000000000022222222000000000000000000000000000001111
11110000000000000000000000000000000000000000000000000000000000000000000000000000000000000000000000001111
11110000000000000000000000000000000000000000000000000000000000000000000000000000000000000000000000001111
11110000000000000000000000000000000003000000000000000000222222220000000000000000000000000000000000001111
11110000000000000000000000000222442222220000000000000000000000000000000000000000000000000000000000001111
11110000000000000000000000000000000000000000000000000000000000000000000000000000000000000000000000001111
11110000000000030000000000000000000000000000000000000000000000000000000000000000000000000000000000001111
22222222222222222222442222222222222222222222222222222222222222222222222222222222222222222222222222222222
22222222222222222222222222222222222222222222222222222222222222222222222222222222222222222222222222222222
22222222222222222222222222222222222222222222222222222222222222222222222222222222222222222222222222222222