000000000000000000000000000000
000000000000000000000000000000
000000000000000000000000000000
111100000000000000000000000000
111100000000000000000000000000
111100000000000000000000000000
111100000000000000000000000000
111100000000000000000000000000
222222222222222222222222222222
222222222222222222222222222222
222222222222222222222222222222